2 2
.........
.........
./.=.7...
.........
.........
.^...^...
.........
O..Wn.O.O
S....OO..
w.......e
........N
OO..sE..O