2 2
....N.....
..........
.........E
...nesw...
W.........
..........
.....S....