0 0
..........
..n.n.n..W
..........
...n.n.n.N
..........
..n.n.n..E
..........
...n.n.n.S
..........